FFFFFFFFFFFFFFFFFFF
WWWWWWWWWWWWWWWWWWW
WEWFFFFFFFFFFWFFFFW
WFFFFFWWWFFFFWFFFFW
WWWWFFWBWFFFFMFFFFW
WFFFFFFFFFFFFWFFFFW
WFWFFFFFFFFFFWFFFFW
WFWWWFFFFFFFFWFFFFW
WHWPFFFFFF2FTWFFFFW
WFWWWFFFFFIFFWFFFFW
WFWFIFFFFWFWFWFFFFW
WIFIIWFFFWFFFWWFFFW
WFWFWWF1FWFFFFWWWFW
WFFIFWFFFWFFFIIKWFW
WFFFFWWWWWFFWWWWWWW
WWWWWWWWWWWWWWWWWWW
FFFFFFFFFFFFFFFFFFF