FFFFFFFFFFFFFFFFFFF
WWWWWWWWWWWWWWWWWWW
WFFFFFWWBWFFFWKWFFW
WFFFFFWFFFFWFWIFFFW
WFFFFFWFFWWWIFFFWFW
WFWWWFWFFWFIFWFFWFW
WFWEWFWMFWWFIFIFWFW
WIFFFFWFFWFIFFFWWFW
WHWWWWWFFWWFIFWWFFW
WFWFFFFFFWFFIWWFIFW
WFWFFFFFFWFFFWWFFFW
WFWWWWFFFWWWWWWWWFW
WF1WFTFFFFFFFFFPWFW
WFFFFFFFFFFFWWWWWFW
WFFFFFFFFF2FFFFFFFW
WWWWWWWWWWWWWWWWWWW
FFFFFFFFFFFFFFFFFFF