FFFFFFFFFFFFFFFFFFF
WWWWWWWWWWWWWWWWWWW
WKFFFFFFFFFFFFFFFFW
WFFFIIIIIIIIFFFFIFW
WFFFFFFFFFFFFFFFIFW
WFFFFFFWWWWWWFFFIFW
WFFFFFFWWPWWIIMFIFW
WFFFFFFWWFWWIIFFFFW
WFFFFFFFFFFFFFFFFFW
WFFFFFFFFFFFFFFFFFW
WFFFFFFWWWFFFFWWWFW
WFFFFFFFFFIIIIHFWFW
WFFWWFFWWWFFFFWEWFW
WFFWWIIFFWFFFFWWWFW
WFFFFFFFFFFFFFFFFFW
WWWWWWWWWWWWWWWWWWW
FFFFFFFFFFFFFFFFFFF