FFFFFFFFFFFFFFFFFFF
0000000000000000000
0000000000000000000
0000000000000000000
0000000000000000000
0000000000000000000
0000000000000000000
00WWW00000000WWW000
00WEW00000000WPW000
00WFWWWWW0000WFW000
00WFWWFFWWWWWWFW000
00WFFFFFFFFFFFFW000
00WFFWWWWFFWWFFW000
00WWWW00WWWWWWWW000
0000000000000000000
0000000000000000000
FFFFFFFFFFFFFFFFFFF