FFFFFFFFFFFFFFFFFFF
WWWWWWWWWWWWWWWWWWW
WFFFFFFFFWIIWIIFFFW
WFWFFFFFFFIIIIFWFFW
WFFFWFFFFFIIIIFWHWW
WFFFFFFFFFIIIIFWFEW
WFFFFFIIIMIFFFFWWWW
WFFFFFIFIIIFFFFFFFW
WFFFFFIFFFFFFFFFFFW
WWIII%FFFFFFIFFFFFW
W&IIIIFFFFFFFFFFFFW
WFFWFFFFFFFFFFWWFFW
WFFFFFFFFFFFFFWWWWW
WFWFWPWFWFFFFFFFFFW
WFFFWWWFFFFFFFFFFFW
WWWWWWWWWWWWWWWWWWW
FFFFFFFFFFFFFFFFFFF