FFFFFFFFFFFFFFFFFFF
WWWWWW000WWWW000000
WFFFFW000WFFWWW0000
WFFFFWWW0WFFFFW0000
WWFFFFMWWWFFFFWW000
0WFFFFIFFWFFFIFWW00
0WFWWFFWFWWFFFIFW00
WWFFWFFFIFFFFFFWWW0
WFFFWFFIFFFFFFFFKW0
WFFFWFW%WWWFWFFFFW0
WFFWWFFIFFWIFFFWWW0
WWFWWWWWWFWFFFIFW00
0WFWWWWPFFWFFIFWW00
0WFHFEWFFFWFFFWW000
0WBWWWWFFFWWFFW0000
0WWW00WWWWWWWWW0000
FFFFFFFFFFFFFFFFFFF