FFFFFFFFFFFFFFFFFFF
000000WWWW0WWWWWW00
000000WFFWWWFFWPW00
000000WFIFFFIFWFW00
00000WWWFWWWFWWFWW0
WWWWWWFFIWWWFFFIFW0
WFFWWWFWFWFWFWWFWW0
WFIFFFIFIFIWIFFIW00
WFIFFFFWFWMWFWWFW00
WFIIWIIFIFIFIFWFWWW
WFIIWFFWFWFWFWWFFFW
WFIIWWFFIFIFIFWWWHW
WFIIWWFFWWFWFFWEFFW
WFIIFWWWWWWWWWWWWWW
WFFFKW0000000000000
WWWWWW0000000000000
FFFFFFFFFFFFFFFFFFF