FFFFFFFFFFFFFFFFFFF
0000000000000000000
0000000000000000000
0000000000000000000
0000000000000000000
0000000000000000000
0000000000000000000
0000000000000000000
0000000000000000000
0000000000000000000
FFFFFFFFFFFFFFFFFFF
FFEFFFFFFFFFFFPFFFF
FFFFFFFFFFFFFFFFFFF
0000000000000000000
0000000000000000000
0000000000000000000
FFFFFFFFFFFFFFFFFFF