FFFFFFFFFFFFFFFFFFF
WWWWWWWWWWWWWWWWWWW
WFFIFFFWWFFFFWFFFFW
WFWFFFFFFFFFFFIFFFW
WFFFWWFFFFWWWFFWWWW
WWWFWWWFFFWWWFFFFPW
WWFFWWWFWFWWFFTFFWW
WWFFFFFIFIFFFFFFFWW
WWWFFFWFWFWFFFFFFFW
WWWFFIFIFIFFFFFFFFW
WFFFFMWFWFWWWWWWWWW
WFFIFFFIFIFFWFFFFIW
WFFFWFFIFIFFWHWEWIW
WFFFFFFFWFFFFIWWWIW
WFFWFFFFWBWFFIIII!W
WWWWWWWWWWWWWWWWWWW
FFFFFFFFFFFFFFFFFFF