FFFFFFFFFFFFFFFFFFF
0000000000000000000
0WWWWW000000WWWWW00
0WFFFWWWWWWWWFFFW00
0WFFFWWFFFFWWFFFW00
0WWFFFFFFFFFFFFWW00
00WFWWWWFFWWWWFW000
00WFW0WFFFFW0WFW000
00WPW0WMFFFW0WEW000
00WWW0WWWWWW0WWW000
0000000000000000000
0000000000000000000
0000000000000000000
0000000000000000000
0000000000000000000
0000000000000000000
FFFFFFFFFFFFFFFFFFF