FFFFFFFFFFFFFFFFFFF
0000000000000000000
0000000000000000000
0000000000000000000
0000000000000000000
0000000000000000000
0000000000000000000
0000000000000000000
0000000000000000000
0000000000000000000
0WWWWWWWWWWWWWWW000
0WEFFFFFFFFFFFPW000
0WWWWWWWWWWWWWWW000
0000000000000000000
0000000000000000000
0000000000000000000
FFFFFFFFFFFFFFFFFFF